top-of-doc=_manual.htm
an-add-attach-p=an-add-attach-p.htm
an-add-fav-p=an-add-fav-p.htm
an-add-photo-p=an-add-photo-p.htm
an-add-version-p=an-add-version-p.htm
an-commenting-p=an-commenting-p.htm
an-cut-paste-p=an-cut-paste-p.htm
an-delete-item-p=an-delete-item-p.htm
an-download-item-p=an-download-item-p.htm
an-favorites-bg=an-favorites-bg.htm
an-following-user-p=an-following-user-p.htm
an-initiate-workflow-p=an-initiate-workflow-p.htm
an-like-p=an-like-p.htm
an-liked-list-p=an-liked-list-p.htm
an-mention-p=an-mention-p.htm
an-my-assignments-bg=an-my-assignments-bg.htm
an-objectdetails-p=an-objectdetails-p.htm
an-on-delete-profile-p=an-on-delete-profile-p.htm
an-on-profile-pic-p=an-on-profile-pic-p.htm
an-on-signing-in-bg=an-on-signing-in-bg.htm
an-post-comment-p=an-post-comment-p.htm
an-post-status-p=an-post-status-p.htm
an-pulse-bg=an-pulse-bg.htm
an-refresh-p=an-refresh-p.htm
an-reserve-p=an-reserve-p.htm
an-search-p=an-search-p.htm
an-searching-feeds-p=an-searching-feeds-p.htm
an-send-as-link-p=an-send-as-link-p.htm
an-settings-bg=an-settings-bg.htm
an-view-attachment-p=an-view-attachment-p.htm
an-view-comment-p=an-view-comment-p.htm
an-view-comments-p=an-view-comments-p.htm
an-workspaces-bg=an-workspaces-bg.htm
