top-of-doc=index.htm
delegate-p=delegate-p.htm
ip-add-attach-p=ip-add-attach-p.htm
ip-changing-profile-pic-p=ip-changing-profile-pic-p.htm
ip-commenting-p=ip-commenting-p.htm
ip-cut-paste-p=ip-cut-paste-p.htm
ip-delete-item-p=ip-delete-item-p.htm
ip-delete-profile-p=ip-delete-profile-p.htm
ip-favorite-p=ip-favorite-p.htm
ip-favorites-bg=ip-favorites-bg.htm
ip-following-user-p=ip-following-user-p.htm
ip-initiate-workflow-p=ip-initiate-workflow-p.htm
ip-like-p=ip-like-p.htm
ip-mention-p=ip-mention-p.htm
ip-notifications-p=ip-notifications-p.htm
ip-post-comment-p=ip-post-comment-p.htm
ip-pulse-bg=ip-pulse-bg.htm
ip-search-p=ip-search-p.htm
ip-searching-feeds-p=ip-searching-feeds-p.htm
ip-send-item-p=ip-send-item-p.htm
ip-share-status-p=ip-share-status-p.htm
ip-signing-in-bg=ip-signing-in-bg.htm
ip-upload-item-p=ip-upload-item-p.htm
ip-view-comment-p=ip-view-comment-p.htm
ip-view-comments-p=ip-view-comments-p.htm
ip-workspaces-bg=ip-workspaces-bg.htm
mod-lles-ip-icons=mod-lles-ip-icons.htm
my-assignments-bg=my-assignments-bg.htm
send-for-review-p=send-for-review-p.htm
sync-ip-objectdetails-p=sync-ip-objectdetails-p.htm
sync-ip-reserve-p=sync-ip-reserve-p.htm
view-attachment-p=view-attachment-p.htm
