top-of-doc=_manual.htm
bb-add-item-p=bb-add-item-p.htm
bb-add-photo-p=bb-add-photo-p.htm
bb-changing-profile-pic-p=bb-changing-profile-pic-p.htm
bb-commenting-p=bb-commenting-p.htm
bb-delete-item-p=bb-delete-item-p.htm
bb-download-p=bb-download-p.htm
bb-edit-profile-p=bb-edit-profile-p.htm
bb-email-item-p=bb-email-item-p.htm
bb-fav-open-file-loc-p=bb-fav-open-file-loc-p.htm
bb-fav-remove-p=bb-fav-remove-p.htm
bb-fav-sync-man-p=bb-fav-sync-man-p.htm
bb-fav-view-p=bb-fav-view-p.htm
bb-favorites-bg=bb-favorites-bg.htm
bb-find-users-p=bb-find-users-p.htm
bb-initiate-wf-p=bb-initiate-wf-p.htm
bb-like-p=bb-like-p.htm
bb-liked-list-p=bb-liked-list-p.htm
bb-mention-p=bb-mention-p.htm
bb-move-p=bb-move-p.htm
bb-my-assignments-bg=bb-my-assignments-bg.htm
bb-post-comment-p=bb-post-comment-p.htm
bb-pulse-bg=bb-pulse-bg.htm
bb-remove-profile-p=bb-remove-profile-p.htm
bb-search-p=bb-search-p.htm
bb-search-pulse-p=bb-search-pulse-p.htm
bb-settings-bg=bb-settings-bg.htm
bb-signing-in-bg=bb-signing-in-bg.htm
bb-update-status-p=bb-update-status-p.htm
bb-view-attach-p=bb-view-attach-p.htm
bb-view-comment-p=bb-view-comment-p.htm
bb-view-comments-p=bb-view-comments-p.htm
bb-view-files-offline-bg=bb-view-files-offline-bg.htm
bb-viewing-attach-p=bb-viewing-attach-p.htm
bb-workspaces-bg=bb-workspaces-bg.htm
